die Ecke, -n|An der nächsten Ecke links.
die Ehefrau, -en/der Ehemann, ä, er|Das ist mein (Ehe-) Mann/meine (Ehe-) Frau.
das Ei, -er|Möchtest du ein Ei zum Frühstück?
eilig|Hast du es eilig?
ein-|Ich nehme ein Bier. Willst du auch eins?
Ist hier einer, der das kann?
einfach|Die Prüfung ist ganz einfach.
Hin und zurück? – Nein, bitte nur einfach.
Ich brauche nur ein einfaches Zimmer.
der Eingang|Der Eingang ist um die Ecke.
einkaufen|Ich muss noch für morgen einkaufen.
einladen|Darf ich Sie zu einem Kaffee einladen?
die Einladung|Danke für die Einladung!
einmal|Diese Prüfung mache ich nicht noch einmal.
einsteigen|Schnell, steig ein, der Zug fährt gleich.
der Eintritt|Der Preis für den Eintritt ist 5 Euro.
das Einzelzimmer|Haben Sie noch ein Einzelzimmer?
die Eltern (pl.)|Meine Eltern leben in Spanien.
die E-Mail, -s|Ich habe Ihre E-Mail nicht bekommen.
der Empfänger, –|Auf dem Brief steht dein Name, also bist du der Empfänger.
empfehlen|Welchen Wein können Sie mir empfehlen?
enden|Die Straße endet hier.
das Ende|Sie wohnt am Ende der Straße.
Er bekommt sein Geld am Ende des Monats.
entschuldigen|Entschuldigen Sie bitte!
die Entschuldigung|Entschuldigung! – Bitte.
er|Er heißt Ali.
das Ergebnis, -se|Das Ergebnis des Tests bekommen Sie in zwei Wochen.
erklären|Kannst du mir das erklären?
erlauben|Rauchen ist hier nicht erlaubt.
der Erwachsene, -n|Dieser Film ist nur für Erwachsene.
erzählen|Wir müssen euch etwas erzählen!
es|Es regnet.
essen|Was gibt es zu essen?
das Essen|Das Essen ist heute sehr gut.
euer|Euer Kurs beginnt heute.